NO wall/NO.xpm

SO wall/SO.xpm

WE wall/WE.xpm

EA wall/EA.xpm





F 155,155,155





C 100,100,100




        1111111111111111111111111
    111 1001000000110000000000001
    101 1001000001110000000000001
    111 1001000000000000000000001
        1001000000000000000000001
111111111011000001110000000000001
100000000011000001110111111111111
11110111111111011100000010001
11110111111111011101010010001
11000000110101011100000010001
10000000000000001100000000001
10003002000000001101022200001
11000001110101011111000000N0211
11110111 1110101 101111010001
11111111 1111111 111111111111
